[
'#########',
'#P..#...#',
'#.###.###',
'#...#...#',
'#.#.#.###',
'#.#.....#',
'#.#####.#',
'#.....#.#',
'#######E#'
]